*****
*...*
*...*
*...*  *F**
*...****..*
*....*.._.*
*.__......*
*.........*
***********

Player 1: 1,1
Player 2: 1,3
