***********
*......__.F
*...***...*
*...***...*
***********
Player 1: 1,1
Player 2: 1,3
