*****   *****
*...*****...*
*._______._.*
*...*****...*
*****   **.**
*.F.*    *_*
*...*    *_*
*._.*   **.**
*...*****. .*
*._......._.*
*...*****...*
*****   *****
Player 1: 1,1
Player 2: 1,3
